15 14
______#_______
___#__#__#____
____#___#*_##_
_#__#___###___
_#_#_#_#____#_
_#__#_#____#__
#_#____#__#__#
__#_#_#__#____
_#_#___#__##__
__#____#____#_
___#____#_#_#_
_#_#_###__#_#_
_#_$#_____##__
__##_#####____
___________#__
